{
    "0": 0,
    "1": 1,
    "2": 2,
    "3": 3,
    "4": 4,
    "5": 5,
    "6": 6,
    "7": 7,
    "8": 8,
    "9": 9,
    "10": 10,
    "a": 11,
    "ā": 12,
    "b": 13,
    "c": 14,
    "č": 15,
    "d": 16,
    "e": 17,
    "ē": 18,
    "f": 19,
    "g": 20,
    "ģ": 21,
    "h": 22,
    "i": 23,
    "ī": 24,
    "j": 25,
    "k": 26,
    "ķ": 27,
    "l": 28,
    "ļ": 29,
    "m": 30,
    "n": 31,
    "ņ": 32,
    "o": 33,
    "p": 34,
    "r": 35,
    "s": 36,
    "š": 37,
    "t": 38,
    "u": 39,
    "ū": 40,
    "v": 41,
    "z": 42,
    "ž": 43,
    " ": 44
}